###################
#...............###
#.##########.##.###
#..........#.##.###
#o#.#.#.##...##..*#
#..........#.##.###
##.#########.##.###
##...........##.###
##.#########....###
###################
