#####################################################################################################
#.#o#.....#.#...#.............#...........#.#.#.....#.............#...#.............#.....#.#.....#.#
#.#.###.#.#.#.###.###.#.#.#####.###.###.###.#.###.#.#.#.###.#####.#.#.#####.#.#.#####.#####.###.###.#
#.#.....#.......#...#.#.#.#.#.....#...#.#.........#.#.#.#.....#.....#...#...#.#.#.#.#.#.......#.....#
#.###.#.#####.#######.#.###.###.###.#.###.#############.###.###########.#######.#.#.#.###.###.###.###
#.....#...#...#...#.#.#.#...#...#...#...#.....#.....#.....#.....#.#.#.#.#.#.#.........#...#.#.#.....#
###.#.#########.###.#.#.###.#.###.#######.#######.###########.#.#.#.#.###.#.#.#.#####.#.#.#.#.###.#.#
#...#.#.........#.....#...#.....#.......#...........#.....#.#.#.#.........#...#.#...#.#.#.#.....#.#.#
#####.#.#####.#####.#######.#######.#####.#############.#.#.#.#.#.#############.#.#.#.#####.###.#.###
#.....#.#.......#...............#.#.....#.............#.#.....#.#.....#.........#.#...#.....#.#.....#
###.#.#.###.#######.#.#######.###.#######.###.#######.#####.#####.#####.#####.#####.#.#.###.#.###.#.#
#...#.....#.#.......#.......#.......#.#...#...#.....#...#.#.....#.#...#.....#.....#.#.#.#...#.#...#.#
#.#.###.#.###.#.###.#.###############.#####.#.###.#.#####.###.#.#.###.#.#######.#####.###.###.#.###.#
#.#...#.#...#.#...#.#.#.......#.......#.#...#...#.#.#.....#...#.......#.#.#.#.#...#...#.#.#.......#.#
#.###.###.#####.#.#.#.###.###.#####.###.#######.###.#.#############.###.#.#.#.###.#####.#.###########
#...#...#...#.#.#.#.#.#...#.....#.#...#.............#.#...#.....#.....#...#.....#...#...#.#...#.....#
#.#.#########.###.#######.#####.#.#.#####.#########.#.#.#######.#.#####.###.#####.#.#.###.#.#.###.###
#.#...#...#...#.#.......#.#.#...#.....#...#.#.......#.......#.....#.......#...#.#.#.........#.......#
#.#.#.###.#.###.###.#.#.###.#.#.#.#########.###.#.#####.#########.#.#######.###.#.###.#####.###.###.#
#.#.#...........#.#.#.#.#.....#...#...#.......#.#...#...#.#.#.........#.#.......#.#.#.#.......#.#.#.#
#.###.###########.#.###.#.#####.###.#.#######.#.###.###.#.#.###.###.###.#######.#.#.#######.###.#.###
#...#.......#.....#...#...#.#.......#.#.....#...#.....#...........#.....#.....#.....#.....#.#.....#.#
#.#####.#####.###.#######.#.#####.#######.#.#######.#########.###########.#.#.###.#####.#########.#.#
#.#.#.......#.#.......#...#.#.....#.....#.#...#...#.........#.......#...#.#.#...#...#.........#...#.#
#.#.#######.###.#####.#####.###.###.#####.#.#.#.#.#.#.#########.###.#.#.#.###.###.#########.#######.#
#...#.#...#.......#.....#...#.#...#.#...#.#.#.#.#...#...........#...#.#.....#.#...#.#.#.#.#.#.......#
###.#.#.#.#.###############.#.#.#.#.#.#.#.###.###.#.#######.#########.###########.#.#.#.#.#.#.###.#.#
#.....#.#...#...#...#.#...#.....#.....#...#.#.....#.......#.#.........#.......#.....#.....#.....#.#.#
#.#.###.#######.#.#.#.###.#########.#.###.#.###.#############.###.#######.#.###.#####.###.#####.#####
#.#.#.#.#.....#.#.#.#.#.......#.....#.#.#.#...#...#.#.#.#.#...#...#.....#.#..*....#.....#.........#.#
#.###.###.#####.#.###.###.###.###.#####.#.###.#####.#.#.#.#.#.#####.#####.#.#.#####.#####.#####.###.#
#...#...........#.....#.#...#.....#.....#...#...#.#.#.....#.#.#.......#...#.#.#...#.#...#.....#.....#
###.###.#.#.#.#.###.#.#.#########.#.###.#.#####.#.#.#.#.#####.#.#####.###.#.#####.###.#.###.#.#.###.#
#.....#.#.#.#.#...#.#.....#.......#.#.#.....#.#.#.#.#.#.#...#.#...#.#.....#.#.....#...#.#...#.#.#...#
#.#.###.#.#.###########.#.#########.#.#####.#.#.#.#.###.###.#.###.#.#############.###.#####.#####.###
#.#...#.#.#...#...#.#...#.......#.#...#...#.......#.....#...............#.#...#.......#.........#...#
#.###.###.###.#.###.###########.#.#####.#####.###.#####.###.#.#.#####.###.#.#.###.###.###.#.###.#####
#...#.....#.#...........#...#.........#...#.#.#...........#.#.#.#.........#.#.#.....#.#...#...#.....#
#######.#.#.###.#######.###.#.#######.#.###.#######.#.###############.#####.#.#####.#########.#.#####
#...#...#.....#.#.........#.....#...................#.#.#.#.#.......#...#.#.#.......#.....#...#.#.#.#
#.#.#.#.#########.#######.#######.###.#.#.#.#####.###.#.#.#.#######.#.#.#.#######.#.#.###.#.#.###.#.#
#.#.#.#.....#.#.#.#...#.#.#.#.....#.#.#.#.#.#.#.#.#.........#.........#.#.#.......#...#.#...#.#...#.#
#.#######.###.#.#.#.###.#.#.#####.#.#####.#.#.#.###.#########.#.#.#####.#.#.#######.###.#.#####.#.#.#
#...............#.....#.#.#.............#.#.#...#.........#.#.#.#.#.#.....#.......#...#.......#.#.#.#
#########.#.#.###.#.#.#.#####.#.#.###########.#.#####.#.#.#.#.#.###.#####.#####.#########.###.###.#.#
#.......#.#.#.#...#.#.#.#...#.#.#...#.....#...#.#...#.#.#...#.#.......#.......#.#...#.......#.......#
#####.###.#.#######.###.#.#######.#######.###.#####.#.###############.#######.#.#.###.#.#.###.#.###.#
#.......#.#...#.#.....#.#.#...#.........#.....#.#.........#.#.#.#...........#.....#...#.#.#...#.#...#
#####.#.#####.#.###.###.#.#.#.#.###.#######.###.###########.#.#.#.###.#.###.###############.###.#####
#.#...#.#.#.#.#.#...........#.#.#.......#...........#...#.#.........#.#...#.#...#.....#.....#...#.#.#
#.#####.#.#.#.#.#.###.###############.###.###.#.#.#.###.#.###.###.###########.###.#.#####.###.#.#.#.#
#.......#.....#.#...#.#.#.....#.....#.....#...#.#.#.#.#.#...#.#...#...#.#.........#...#.....#.#.....#
#.#.#######.###.#.###.#.#.#.#.###.###.#######.###.###.#.#.#####.###.###.#.#######.#.###.#.#.###.###.#
#.#.#.....#.#.#...#...#...#.#...........#...#.#.#.#.#...............#.........#.#.#...#.#.#.#...#.#.#
###.#.###.###.#####.###.#######.#######.#.#####.###.#.#######.###.#####.#.#####.###.#.#########.#.###
#.....#.....#...#.....#.....#...#.....#.#.....#.....#.#.#...#...#.#.#...#.#.........#.#.#...#.#.....#
#.#####.#.###.#.#####.#.#.#.#.###.#####.###.#####.#.###.###.#####.#.#####.#####.#######.###.#.#.###.#
#...#...#.....#...#.....#.#.#...#.................#.........#.#...#.......#.....#.............#...#.#
#.#########.#####.#.###########.#.###.#.#####.#.#######.###.#.#.#.#####.#######.###.#.#.###.#####.#.#
#...#.#...#.#...#...#.......#.#.#...#.#...#.#.#...#...#.#.#.#...#...#...#.#.....#...#.#...#.#.....#.#
#.###.###.#####.###.#####.###.###.#######.#.###.###.#.###.###########.###.###.###.#######.#.#.#######
#...#...#.........#.....#...#.....#.....#.#...#.#...#.........#.#...#.#.#.#.#.#.#.#.....#.#.#.#.....#
###.###.#####.###.#.###.#.#.#.#.#.###.#.###.###.###.###########.#.#.#.#.#.#.#.#.#.#.#######.#.#.#.#.#
#.#.#.........#...#...#...#.#.#.#.#...#.#.................#.#.#...#.......#.....#.....#...#.....#.#.#
#.#.###.###.#.#####.#.#.#.#.###########.#####.#.#.#####.###.#.#####.###.#####.#####.#####.#########.#
#.....#.#...#.#.#...#.#.#.#.........#.#...#...#.#.#...#.....#...#...#...#.#.......#.#.....#.#.......#
#.#####.###.###.###.#################.###.#.#.###.#.#.#.#.#.#.#.###.#.###.#.#.#.#####.#####.###.###.#
#.#...#.#.......#.......#.#...#.#.....#.....#.#.....#.#.#.#.#.#...#.#...#.#.#.#.#...............#...#
#.#.#####.#.###.#.###.###.###.#.#.#.#.#.#########.#.#############.#.#####.#.###.#####.#.#.#.###.#.#.#
#.#.#...#.#.#.#.#...#...#...#.#...#.#.....#.....#.#.#.....#.#.#.#.....#...#...#...#...#.#.#.#.#.#.#.#
###.#.#.#.#.#.###.#.#.#.#.###.###.#.#######.#.###.###.#####.#.#.#.###.###.#.#######.#.#.#.###.#.#####
#...#.#.#.#.......#.#.#.#.....#.#.#...#.....#...#.#...........#.....#.#.#.......#.#.#.#.#.#.#...#.#.#
#.#.#.#####.#.#.#.#.#####.#####.#########.###.#.#.#######.#####.#.#####.#####.###.#.#######.#.#.#.#.#
#.#.........#.#.#.#.....#.#.#...#.....#.#.#...#.....#.#.........#.#.....#.....#.......#.#.#.#.#.....#
#.#####.#.###.###.#.###.#.#.###.#.#.###.###.#.#.###.#.#.###############.#.#.#.###.#.###.#.#.###.#####
#...#...#.#.....#.#.#.......#.....#.#...#.#.#.#...#...#...#.....#...#.#...#.#...#.#.#...#.....#.....#
###.###.###.#.#######.###.#.#######.###.#.###.#.###.###########.#.###.#.#####.###.#.###.#.#.#.#.#.###
#...#.#.#.#.#.....#...#...#.#.#...#.........#.#...#.......#...#...#.....#...#...#.#...#...#.#...#.#.#
#.###.#.#.###########.#######.#.#.#.#.###.#####.#########.###.#.###########.###.#.#########.###.###.#
#.#.#...#.#.........#.#.#.......#...#...#...#.#.#.........#...#.....#.............#.#...#.#.#...#.#.#
###.#####.#####.#.#####.#.###.#.#####.#######.#####.#.#######.#.###.#############.#.#.#.#.###.#.#.#.#
#.....#.........#...#.#.#.#.#.#.....#.#.#...#.....#.#.#.#.#.......#.#...#.........#...#...#...#.....#
###.#############.###.#.#.#.###.###.###.###.#.#######.#.#.###.#.#.###.###.#######.#.#########.#######
#.................#.....#...#.#.#.#.#.........#.....#...#.#...#.#.#...#...#.....#.#...#...#.#.....#.#
#####.#####.#.#.###.#######.#.#.#.#.###.###.#.#.#####.###.#.###.#.#.###########.#.#.#.###.#.#.#####.#
#.......#...#.#.#.#.#.#...#.#...#.#.....#...#...#...#.........#.#.....#.....#.......#.....#.........#
#####.###########.#.#.###.###.###.#.#######.###.#.#.#####.###.#.###########.###########.###.#########
#.....#...#.#...............#...#.....#.#.....#.#.#...#...#...#...#...#.#...........#.#.#...#...#...#
#####.#.#.#.#.###.###.#####.###.###.###.#####.#.#.#.#.#####.###.#.###.#.###.###.#####.#####.###.###.#
#...#...#.....#...#...#...#...#...#.#.#...#...#...#.#.....#.#...#.#.#...#...#...#.#...#.#.....#.#...#
#.#.#########.#.###.#####.#.#.#.#####.#.#######################.#.#.#.#########.#.#.###.#.#####.###.#
#.#...#...#...#.#.......#.#.#.......#.#...#.#.#...#.....#.#.#...#.#...#.#.....#.........#...#.#...#.#
#####.###.#.###.###.#.###.#.#.###.###.#.#.#.#.#.#.#.#.###.#.#.#######.#.#####.###.#######.###.#.###.#
#.#.#.........#.#...#.#.#...#.#.#...#...#...#...#...#.........#...#.......#.#...#...............#...#
#.#.#.#.###.#####.#.###.###.###.#.#.#.#.#.###.###.#####.#####.###.###.#.###.#.#.#.#####.#.#######.#.#
#.....#.#.#...#.#.#...#.....#.....#.#.#.#...#...#...#.#.....#.#...#...#.......#.....#...#...#.....#.#
#.#######.#.###.###.#.#.#.#####.###.#.###############.#.###.#.#.#.###.#.###.#.###.#.#.#############.#
#...#.........#.#...#.#.#...#.#...#.....#.......#...#...#...#.#.#.#...#.#.#.#...#.#.#.......#.#.#...#
###.###.###.#.#.###.#.#.#####.###.###.###.#.#######.#.###.#.#.###.#.#.###.###.#####.#####.###.#.#.###
#...#...#...#.#.....#.#.........#.#.......#.............#.#.#.#.....#...#.....#.....#...............#
#####################################################################################################
