################
#o.............#
#.############.#
#.##*#.........#
#.##.#.#########
#.#..#.......###
#.#.########.###
#.#..........###
#.##############
#.............*#
################